%%%%%%%%%%%%%%%%%%%%
%.      B    ..%   %
%.%%.%%.%%.%%.%% % %
%        P       % %
%%%%%%%%%%%%%%%%%% %
%.....  B          %
%%%%%%%%%%%%%%%%%%%%
